###E###########
#....V#...PF..#
#####.#######.#
#...#.......#.#
###.#######.#.#
#.......#...#.#
#.#.#####.###.#
#.#.#P....#...#
#.###.#######.#
#.#...#.....#.#
#.#.###.#.#.#.#
#.#.#...#.#.#.#
#.#.#####.#.#.#
#F........#...#
############S##
