##########E####
##.....#...#.##
##.##..#.###.##
##...#...#...##
####.#####.####
##.#..P......##
##.##.###..#.##
##..V....#..P##
########.#.####
#.F......#.#.##
##.#.#####.#.##
##...........##
##.#.#.#.######
#..#...#F..V.##
#S#############
